111011101110001
101010101010001
111010101010111
001011101110101
111000000000111
000000000000000
100010101110000
100010101010000
111011101110000
101000101000000
111011101110000